{
  "map": [
   [ 90, 90, 90, 90, 90, 90, 90, 90, 90, 90, 90, 90, 90, 90, 90, 342, 90, 90, 90, 90, 90, 90 ,90 ,90,90, 90, 90, 90, 90, 90, 90, 90, 90, 90, 90, 90 ],
   [ 90, 90, 90, 90, 90, 90, 90, 90, 90, 90, 90, 90, 90, 90, 90, 90, 342, 342, 342, 342, 342, 90 ,90 ,90,90, 90, 90, 342, 90, 90, 90, 90, 90, 90, 90, 90 ],
   [ 90, 90, 90, 90, 90, 90, 90, 90, 90, 90, 90, 90, 90, 90, 90, 90, 90, 90, 90, 90, 90, 90 ,90 ,90,90, 90, 90, 90, 90, 90, 90, 90, 90, 90, 90, 90 ],
   [ 90, 90, 90, 90, 90, 90, 90, 90, 90, 90, 90, 90, 90, 90, 90, 90, 90, 90, 90, 90, 90, 90 ,90 ,90 ,90, 115, 90, 90, 90, 90, 90, 90, 90, 90, 90, 90 ],
   [ 90, 90, 90, 90, 90, 90, 90, 90, 90, 90, 90, 90, 90, 90, 90, 90, 90, 90, 90, 90, 90, 90 ,90 ,90,90, 90, 90, 90, 90, 90, 90, 90, 90, 90, 90, 90 ],
   [ 90, 90, 90, 90, 90, 90, 90, 90, 90, 90, 90, 90, 90, 90, 90, 90, 90, 90, 90, 90, 90, 90 ,90 ,90,90, 90, 90, 90, 90, 342, 90, 90, 90, 90, 90, 90 ],
   [ 90, 90, 90, 90, 90, 90, 90, 90, 90, 90, 90, 90, 90, 90, 90, 90, 90, 90, 90, 90, 90, 90 ,90 ,90,90, 90, 90, 90, 90, 90, 342, 90, 90, 90, 90, 90 ],
   [ 90, 90, 90, 90, 90, 90, 90, 90, 90, 90, 90, 90, 90, 90, 90, 90, 90, 90, 90, 90, 90, 90 ,342 ,90,90, 90, 90, 90, 90, 90, 342, 90, 90, 90, 90, 90 ],
   [ 90, 90, 90, 90, 90, 90, 90, 90, 90, 90, 90, 90, 90, 90, 90, 90, 90, 90, 90, 90, 90, 90 ,90 ,115, 115, 115, 190, 190, 191, 191, 90, 342, 90, 90, 90, 90 ],
   [ 90, 90, 90, 90, 90, 90, 90, 90, 90, 90, 90, 90, 90, 90, 90, 90, 90, 90, 90, 90, 90, 90 ,90 ,90,90, 90, 90, 90, 90, 90, 90, 90, 90, 90, 90, 90 ],
   [ 90, 90, 90, 90, 90, 90, 90, 90, 90, 120, 121,90, 90, 90, 90, 90, 90, 90, 90, 90, 90, 90 ,90 ,90,90, 90, 90, 90, 90, 90, 90, 90, 90, 90, 120, 121 ],
   [ 90, 90, 90, 90, 90, 90, 90, 90, 90, 158,159, 90, 90, 90, 90, 90, 90, 90, 342, 342, 342, 342 ,90 ,90,90, 90, 90, 90, 90, 90, 90, 90, 90, 90, 158, 159 ],
   [ 90, 90, 90, 90, 90, 90, 90, 90, 90, 158, 159, 90, 90, 90, 90, 90, 90, 90, 90, 90, 90, 90 ,90 ,90 ,90,90, 90, 90, 90, 90, 90, 90, 90, 90, 158, 159 ],
   [ 1, 1, 1, 1, 1, 1, 1, 1, 1, 1, 1, 1, 1, 1, 1, 2, 342, 342, 0, 1, 1, 1, 1, 1, 1, 1, 1, 1, 1, 1, 1, 1, 1, 1, 1, 1, 1, 1, 1, 1, 1, 1, 1, 1, 1, 1, 1 ],
   [ 39, 39, 39, 39, 39, 39, 39, 39, 39, 39, 39, 39, 39, 39, 39, 40, 90, 90, 38, 39, 39, 39, 39, 39, 39, 39, 39, 39, 39, 39, 39, 39, 39, 39, 39, 39 ]
 ],
  "playerStart": [
    [50, 200]
  ],
 "mobs": {
   "goomba": [
     [600, 200],
     [800, 200],
     [850, 200],
     [900, 200]
   ],
   "troopa": [
     [1400, 500]
   ],
   "piranha": [
     [456, 490]
   ]
 },
 "coins": [
    [200, 200],
    [250, 200],
    [300, 200],
    [350, 200]
 ],
 "warps": [
    [456, 470, 1665, 470]
 ]
}