{
  "map": [
    [159, 90, 90, 90, 90, 90, 90, 90, 90, 90, 90, 90, 90, 90, 90, 90, 90, 90, 90, 90],
    [159, 90, 90, 90, 90, 90, 90, 90, 90, 90, 90, 90, 90, 90, 90, 90, 90, 90, 90, 90],
    [159, 90, 90, 90, 90, 90, 90, 90, 90, 90, 90, 90, 90, 90, 90, 90, 90, 90, 90, 90],
    [159, 90, 90, 90, 90, 90, 90, 90, 90, 90, 90, 90, 90, 90, 90, 90, 90, 90, 90, 90],
    [159, 90, 90, 90, 90, 90, 90, 90, 90, 90, 90, 90, 90, 90, 90, 90, 90, 90, 90, 90],
    [159, 90, 90, 90, 90, 90, 90, 90, 90, 90, 90, 90, 90, 90, 90, 90, 90, 90, 90, 90],
    [159, 90, 90, 90, 90, 90, 90, 90, 90, 90, 90, 90, 90, 90, 90, 90, 90, 90, 90, 90],
    [198, 199, 200, 90, 90, 90, 90, 90, 90, 90, 90, 90, 90, 90, 90, 90, 90, 90, 90, 90],
    [236, 237, 238, 90, 90, 90, 90, 90, 90, 90, 90, 90, 90, 90, 90, 90, 90, 90, 90, 90],
    [342, 342, 342, 342, 342, 90, 90, 90, 90, 90, 90, 90, 90, 90, 90, 90, 90, 90, 90, 90],
    [342, 342, 342, 342, 342, 342, 90, 90, 120, 121, 90, 90, 120, 121, 90, 90, 120, 121, 90, 90],
    [342, 342, 342, 342, 342, 342, 342, 90, 158, 159, 90, 90, 158, 159, 90, 90, 158, 159, 342, 342],
    [342, 342, 342, 342, 342, 342, 342, 342, 158, 159, 90, 90, 158, 159, 90, 90, 158, 159, 342, 342],
    [1, 1, 1, 1, 1, 1, 1, 1, 1, 1, 1, 1, 1, 1, 1, 1, 1, 1, 1, 1],
    [39, 39, 39, 39, 39, 39, 39, 39, 39, 39, 39, 39, 39, 39, 39, 39, 39, 39, 39, 39]
  ],
  "playerStart": [
    [0, 370]
  ],
  "worldPipes": [
    [408, 470],
    [600, 470],
    [792, 470]
  ]
}